17 12
1 1 1 1 1 1 1 1 1 1 1 1 1 1 1 1 1
1 0 1 2 3 4 5 1 1 1 1 1 1 1 1 1 1
1 0 1 8 0 10 9 1 1 1 1 1 1 1 1 1 1
1 20 7 8 0 16 17 1 1 1 1 1 1 1 1 1 1
1 1 1 1 1 1 1 1 1 1 1 1 1 1 1 1 1
1 12 13 14 15 22 23 1 1 1 1 1 1 1 1 1 1
1 15 18 14 18 14 15 1 1 1 1 1 1 1 1 1 1
1 15 16 20 21 14 15 1 1 1 1 1 1 1 1 1 1
1 1 1 1 1 1 1 1 1 1 1 1 1 1 1 1 1
1 1 1 1 1 1 1 1 1 1 1 1 1 1 1 1 1
1 1 1 1 1 1 1 1 1 1 1 1 1 1 1 1 1
1 1 1 1 1 1 1 1 1 1 1 1 1 1 1 1 1