18 12
1 1 1 1 1 1 1 1 1 1 1 1 1 1 1 1 1 1
2 2 2 2 2 2 2 2 2 2 2 2 2 2 2 2 2 2
2 1 2 14 8 14 8 2 2 2 2 2 2 2 2 2 2 2
2 1 2 12 5 12 5 2 2 2 2 2 2 2 2 2 2 2
2 9 10 12 5 16 15 2 2 2 2 2 2 2 2 2 2 2
2 0 2 2 2 2 2 2 2 2 2 2 2 2 2 2 2 2
2 0 0 2 2 2 2 2 2 2 2 2 2 2 2 2 2 2
2 0 0 2 2 2 2 2 2 2 2 2 2 2 2 2 2 2
2 0 0 0 2 2 2 2 2 2 2 2 2 2 2 2 2 2
2 2 2 2 2 2 2 2 2 2 2 2 2 2 2 2 2 2
2 2 2 2 2 2 2 2 2 2 2 2 2 2 2 2 2 2
2 2 2 2 2 2 2 2 2 2 2 2 2 2 2 2 2 2