16 12
1 1 1 1 1 1 1 1 1 1 1 1 1 1 1 1
1 1 1 1 1 1 1 1 1 1 1 1 1 1 1 1
1 1 1 1 1 1 1 1 1 1 1 1 1 1 1 1
1 1 1 1 8 8 8 1 1 1 1 1 1 1 1 1
1 1 1 8 8 8 8 8 1 1 1 1 1 1 1 1
1 1 1 1 1 12 11 11 6 1 1 1 1 1 1 1
1 1 1 5 11 13 1 1 1 1 1 1 1 1 1 1
1 1 1 1 1 7 1 1 1 1 1 1 1 1 1 1
18 9 1 1 1 7 10 1 1 1 1 1 1 1 1 1
0 0 0 0 0 0 0 0 0 0 18 1 1 1 1 1
0 0 0 0 0 0 0 0 0 0 0 0 0 0 0 0
2 2 2 2 2 2 2 2 2 2 2 2 2 2 2 2