13 12
1 1 1 1 1 1 1 1 1 1 -1 -1 -1
1 1 1 1 1 1 1 1 1 1 1 1 1
1 1 1 1 1 1 1 1 1 1 1 1 1
1 1 1 1 1 1 1 1 1 1 1 1 1
1 1 1 1 1 1 1 1 1 1 1 1 1
1 1 1 1 1 1 1 1 1 1 1 1 1
1 1 1 1 1 1 1 1 1 1 1 1 1
1 1 1 1 1 1 1 1 1 1 1 1 1
18 1 1 1 1 1 1 1 1 1 1 1 1
0 18 19 20 18 1 1 1 1 1 1 1 1
0 0 0 0 0 0 0 0 0 0 14 14 14
16 16 16 16 16 16 16 16 16 16 15 15 15